[
7 0 0 0 0 0 0 0 0 0 0 0 0 0 0 0 0 0 
8 0 0 8 8 8 8 0 0 0 8 8 8 8 8 0 0 0 
8 0 0 8 0 0 8 0 0 0 8 0 0 0 8 0 0 0 
8 0 8 8 0 0 8 8 0 8 8 0 0 0 8 8 0 0 
8 0 8 0 0 0 0 8 0 8 0 0 0 14 0 8 0 0 
8 0 8 0 0 0 0 8 0 8 0 8 8 8 0 8 0 0 
8 0 8 0 0 0 0 8 0 8 0 8 0 0 0 8 0 0 
8 0 8 0 0 0 0 8 0 8 0 8 0 0 0 8 0 0 
8 0 8 0 0 0 0 8 0 8 0 8 8 0 0 8 0 0 
8 0 8 8 0 0 8 8 0 8 0 0 8 0 0 8 0 0 
8 0 0 8 0 0 8 0 0 8 0 0 8 0 0 8 0 0 
8 0 0 8 0 0 8 0 0 8 0 0 8 0 0 8 0 0 
8 0 0 8 0 0 8 0 0 8 0 0 8 0 0 8 0 0 
8 8 8 8 0 0 8 8 8 8 0 0 8 8 8 8 0 0 
0 0 0 0 0 0 0 0 0 0 0 0 0 0 0 0 0 0 
0 0 0 0 0 0 0 0 0 0 0 0 0 0 0 0 0 0 
0 0 0 0 0 0 0 0 0 0 0 0 0 0 0 0 0 0 
0 0 0 0 0 0 0 0 0 0 0 0 0 0 0 0 0 0 
]
( 16 , 16 )
