[
0 0 0 0 0 0 0 0 7 0 0 0 0 0 0 0 0 0 
0 0 0 0 0 0 0 0 8 0 0 8 8 8 8 8 0 0 
0 0 0 0 0 0 0 0 8 0 0 8 0 0 0 8 0 0 
0 0 0 0 0 0 0 0 8 0 0 8 0 0 0 8 0 0 
0 8 8 8 8 8 8 8 8 0 0 8 0 0 0 8 0 0 
0 8 0 0 0 0 0 0 0 0 0 8 0 0 0 8 0 0 
0 8 0 0 0 0 0 0 0 0 0 8 0 0 0 8 0 0 
0 8 0 0 0 0 0 0 0 0 0 8 0 0 0 8 0 0 
0 8 0 0 14 8 8 8 8 8 8 8 0 0 0 8 0 0 
0 8 0 0 0 0 0 0 0 0 0 0 0 0 0 8 0 0 
0 8 0 0 0 0 0 0 0 0 0 0 0 0 0 8 0 0 
0 8 0 0 0 0 0 0 0 0 0 0 0 0 0 8 0 0 
0 8 0 0 0 0 0 0 0 0 0 0 0 0 0 8 0 0 
0 8 0 0 0 0 0 0 0 0 0 0 0 0 0 8 0 0 
0 8 0 0 0 0 0 0 0 0 0 0 0 0 0 8 0 0 
0 8 8 8 8 8 8 8 8 8 8 8 8 8 8 8 0 0 
0 0 0 0 0 0 0 0 0 0 0 0 0 0 0 0 0 0 
0 0 0 0 0 0 0 0 0 0 0 0 0 0 0 0 0 0 
]
( 272 , 16 )
