[
0 0 0 0 0 0 0 0 0 0 0 0 0 0 0 0 0 0 
0 0 0 0 0 0 0 0 0 0 0 0 0 0 0 0 0 0 
0 0 0 0 0 0 0 0 0 0 0 0 0 0 0 0 0 0 
0 0 0 0 0 0 0 0 0 0 0 0 0 0 0 8 8 14 
0 0 0 0 0 0 0 0 0 0 0 0 0 0 0 8 0 0 
0 0 0 0 0 0 8 8 8 8 8 8 8 0 0 8 0 0 
0 0 0 0 0 0 8 0 0 0 0 0 8 0 0 8 0 0 
0 0 0 0 0 0 8 0 0 0 0 0 8 0 0 8 0 0 
0 0 0 0 0 0 8 0 0 0 0 0 8 0 0 8 0 0 
0 0 0 0 0 0 8 0 0 0 0 0 8 0 0 8 0 0 
7 8 8 8 8 8 8 0 0 0 0 0 8 0 0 8 0 0 
0 0 0 0 0 0 0 0 0 0 0 0 8 0 0 8 0 0 
0 0 0 0 0 0 0 0 0 0 0 0 8 0 0 8 0 0 
0 8 8 8 8 8 8 8 8 8 8 8 8 0 0 8 0 0 
0 8 0 0 0 0 0 0 0 0 0 0 0 0 0 8 0 0 
0 8 0 0 0 0 0 0 0 0 0 0 0 0 0 8 0 0 
0 8 8 8 8 8 8 8 8 8 8 8 8 8 8 8 0 0 
0 0 0 0 0 0 0 0 0 0 0 0 0 0 0 0 0 0 
]
( 16 , 336 )
H
