[
0 0 0 0 0 0 0 0 0 0 0 0 0 0 0 0 0 0 
0 0 0 0 8 8 8 0 0 0 0 0 0 0 0 0 0 0 
0 0 0 0 8 0 8 0 0 0 0 8 8 8 0 0 0 0 
0 0 0 0 8 0 8 0 0 0 0 8 0 8 0 0 0 0 
0 0 0 0 8 0 8 0 0 0 0 8 0 8 0 0 0 0 
0 0 0 0 8 0 8 0 0 0 0 8 0 8 0 0 0 0 
0 0 0 0 8 0 8 0 0 0 0 8 0 8 0 0 0 0 
0 0 0 0 8 0 8 0 0 0 0 8 0 8 0 0 0 0 
0 0 0 0 8 0 8 0 0 0 0 8 0 8 0 0 0 0 
7 8 0 0 8 0 8 0 0 0 0 8 0 8 0 0 0 0 
0 8 0 0 8 0 8 0 0 0 0 8 0 8 0 0 0 0 
0 8 0 0 8 0 8 0 0 0 0 8 0 8 0 0 0 0 
0 8 0 0 8 0 8 8 0 0 0 8 0 8 0 0 0 0 
0 8 0 0 8 0 0 8 0 0 8 8 0 8 8 8 8 14 
0 8 0 0 8 0 0 8 0 8 8 0 0 0 0 0 0 0 
0 8 0 0 8 0 0 8 8 8 0 0 0 0 0 0 0 0 
0 8 0 0 8 0 0 0 0 0 0 0 0 0 0 0 0 0 
0 8 8 8 8 0 0 0 0 0 0 0 0 0 0 0 0 0 
]
( 16 , 304 )
H
