[
0 0 0 0 0 0 0 0 0 0 0 0 0 0 0 0 0 0 
0 0 0 0 0 0 0 0 0 0 0 0 0 0 0 0 0 0 
0 0 0 0 0 0 0 0 0 0 0 0 0 0 0 0 0 0 
0 0 0 0 0 0 0 0 0 0 0 0 0 0 0 5 5 10 
0 0 0 0 0 0 0 0 0 0 0 0 0 0 0 5 0 0 
0 0 0 0 0 0 5 5 5 5 5 5 5 0 0 5 0 0 
0 0 0 0 0 0 5 0 0 0 0 0 5 0 0 5 0 0 
0 0 0 0 0 0 5 0 0 0 0 0 5 0 0 5 0 0 
0 0 0 0 0 0 5 0 0 0 0 0 5 0 0 5 0 0 
0 0 0 0 0 0 5 0 0 0 0 0 5 0 0 5 0 0 
5 5 5 5 5 5 5 0 0 0 0 0 5 0 0 5 0 0 
0 0 0 0 0 0 0 0 0 0 0 0 5 0 0 5 0 0 
0 0 0 0 0 0 0 0 0 0 0 0 5 0 0 5 0 0 
0 5 5 5 5 5 5 5 5 5 5 5 5 0 0 5 0 0 
0 5 0 0 0 0 0 0 0 0 0 0 0 0 0 5 0 0 
0 5 5 0 0 0 0 0 0 0 0 0 0 0 0 5 0 0 
0 0 5 5 5 5 5 5 5 5 5 5 5 5 5 5 0 0 
0 0 0 0 0 0 0 0 0 0 0 0 0 0 0 0 0 0 
]
( 16 , 304 )
